
22 305
-------------------------------------------------io--------------------------------------------kl---------------------------io-------------------------------------------------------------------------------------------kl-----------------------------------io------------------------------------------------
-------------------------------------------------kl-------------------------io----------------------------------------------kl--------------------------------------------------------------------------------------------------------------------------------kl--------------------io--------------------------
--------------------------io------------------------------------------------kl-----------------------io---------------------------------------io---------------------------io-----------------------------------------------------------------io------------------------------------kl--------------------------
--------------------------kl-------------------------------------------------------------------------kl---------------------------------------kl---------------------------kl----------------------------------io-----------------------------kl----------------------------------------------------------------
-----------------------------------------------------------------------------------------------------------------------111111----------------------------------------------------------------------------------kl-----------------------------------------------------------------------------------io----------
-------------------------------------------------------io-------------------------------------------------------------------------------------------------------------------------------------------------------------------------------------------------------------------------------------------kl----------
-------------------------------------------------------kl-------------------------------------------------------------------------------------------------------------------------------------------------------------------------------------------------------------------------------------------------------
----------------------------------------------------------------------------------------------------------------------------------------------------------------------------------------------------------------------------------------------------------------------------------------------------------------
-------------------------------------------------------------------------------------------------------------------------22--------------------------------------------------------------------------------------------------------------------------------------------------------------------------------F-t--
-----------------------------------------------------------------------------------------------------------------------------------------------------------------------------------------------------------------------------------------------------------------------------------------------------------F-m--
------------------------------------------------------------------------------------------g-------------------------------------------------------------------21111112----------------------2--------------------------------------------------------------------------------------------------------------F-m--
----------------g-----g---------------g-------------g-------------------2---------g---------------gg-----------------------------------------------------------------------------------------------------------------------------------3-------------------------------------------------------------------F-m--
-----------------------AB------g-------------g------------g--------AB----------------AB------AB------------------------3-----3-------gg--------gg----------gg---------------------------------------gg----------------------AB--------33-gg-----g-----g---------gg-----gg-----GG---------------------------F-m--
-----------------------CD------------------------------------------CD--------AB------CD------CD----------------AB------3-----3-----------------------------------------------------------------------------------------AB---CD-------333--------------------------------------AB-----GG------------33------F-m--
-----------------------CD------------------------------------------CD--------CD------CD------CD--------AB------CD------3-----3--------------------------------------------------------------3--------------------AB----CD---CD------3333-----------------3ggg3---------------3CD-----AB--------33--33------F-m--
1-1-1-----------3--f---CD------------------------------------------CD-----s--CD---e--CD--gg--CD----s---CD------CD------3--s--3-----------gg----------gg----3----f----f---3------------------3--------------------CD----CD---CD--s--33333-----------------3ggg3----------------CD---s-CD----33--33--33------F-b--
4444444444444444444444444449--549--54449--54449--54449---544444444444444444444444444444444444444444444444444444444444444444444449--549--54449--549--54449--544444444444449--549--549--5444444444449----5444449--5449--5449--5444444444444444449---549---5444449----549----544444444444449--59--59--59--5444449--
7777777777777777777777777778--678--67778--67778--67778---677777777777777777777777777777777777777777777777777777777777777777777778--678--67778--678--67778--677777777777778--678--678--6777777777778----6777778--6778--6778--6777777777777777778---678---6777778----678----677777777777778--68--68--68--6777778--
7777777777777777777777777778--678--67778--67778--67778---677777777777777777777777777777777777777777777777777777777777777777777778--678--67778--678--67778--677777777777778--678--678--6777777777778----6777778--6778--6778--6777777777777777778---678---6777778----678----677777777777778--68--68--68--6777778--
7777777777777777777777777778--678--67778--67778--67778---677777777777777777777777777777777777777777777777777777777777777777777778--678--67778--678--67778--677777777777778--678--678--6777777777778----6777778--6778--6778--6777777777777777778---678---6777778----678----677777777777778--68--68--68--6777778--
7777777777777777777777777778--678--67778--67778--67778---677777777777777777777777777777777777777777777777777777777777777777777778--678--67778--678--67778--677777777777778--678--678--6777777777778----6777778--6778--6778--6777777777777777778---678---6777778----678----677777777777778--68--68--68--6777778--
7777777777777777777777777778--678--67778--67778--67778---677777777777777777777777777777777777777777777777777777777777777777777778--678--67778--678--67778--677777777777778--678--678--6777777777778----6777778--6778--6778--6777777777777777778---678---6777778----678----677777777777778--68--68--68--6777778--
33333333333---33---33-----3333333333333333333333333333333333333333------3333333333333333333333333333333333--33--33------333333--------33333333333333333-------33333333333333333---333333-----33333333333333333---------------------